XXXXXXXXXXXXXXXX
X              X
XXXX XXXXXXX XXX
X    XXXXXXX XXX
XXOXXXXXXX   XXX
XX XXXXX   XXXXX
XX XXXXX XXXXXXX
XX       OOOOXXX
XXXXXXXX XXXXXXX
XXXXX       XXXX
XXXXXXXX XXXXXXX
XXXXXXXX XXXXXXX